#########
#..G....#
#.......#
#.....G.#
#.......#
#.......#
#.G.....#
#.....E.#
#########